{
    "06_18to14_07": [
        "06_18",
        "06_17",
        "06_16",
        "07_16",
        "07_15",
        "06_15",
        "06_14",
        "07_14",
        "07_13",
        "07_12",
        "08_12",
        "09_12",
        "09_11",
        "10_11",
        "10_12",
        "11_12",
        "11_11",
        "11_10",
        "11_09",
        "12_09",
        "12_10",
        "13_10",
        "13_09",
        "14_09",
        "15_09",
        "15_08",
        "15_07",
        "14_07"
    ]
}